111111111111111111111111111111111111111111111111
111111111111111111111111111111111111111111111111
111111111111111111111111111111111111111111111111
111111111111111111111111111111111111111111111111
111113333333333331111111111333333333333311111111
111113000000000031111111111344443444444333331111
111113303333333333333331111344444444444344531111
111119999999999999000633333344443444444344431111
111119000000999999000033444444443644444334331111
111119003000990099000004443333333444444444731111
111119003000990099000004443111113333343333331111
111119000000999999000034443111111111343136433331
111119999999999999000734443111111111343134444431
111119333333333333333334443111111111343134449431
111119132344444464444434443333333333343333433331
111119132244444444444434443444344444344444444311
111119133344444333344434444444444444444444444311
111119111344444311344444443444344444333333333311
111119111344444311344444443333334347311130009331
111119111344444333344434443111134333333330000031
111119111344444444444434443111134300000000000031
111119111344444444444434443111134300000033330031
111119991333333323333334443333334333333331130031
111119999111111121111133444444444731380031130031
111119999911111122111134444333333333300033330031
111119999911111221113334433300000000000000000031
111119999922112211113444430000333333330333333331
111119999112222111199949930033311111300030000311
111119911111133311199994930060333333330030000311
111119033333131111111344430000030031130000000311
111113000003333333311300030000000033330000000311
111113006000000000333300000033000000000007000311
111113000003330000000000333333333330330000000311
111113330333130000000000000000000000030000000311
111111130311133330033333333300033300030000000311
111111130311332230032223113600031300033330033311
111111130311322220022223113300033300031300000311
111111130311322230032223111300000000033300000311
111111130311333330033333111300000000000000000311
111111130311322230032223333333003330033333033311
111111130311322220022223003000003130030000009911
111111130311322230032223000000003130000007009991
111113330333333330033333333006003130000000099991
111113000000000000000031113000003333330000999991
111113000000033333000031113000000000000000999911
111113000000031113000031113333333333000009999111
111113333333331113333331113111111113333333333311
111111111111111111111111111111111111111111111111