1111111111111111111111111111111111111111111111111111111111111111
1111111111111111111111111111111111111111111111111111111111111111
1111111111111111111111111111111111111111111111111111111111111111
1111111111111111111111111111111111111111111111111111111111111111
1111110060000000000600006000000666000600000000000060000011111111
1111116600000060000000000006000000000006000006000000000600000111
1111160006000000000000600000006000000060000060000000000600000001
1111100000060000000000000000000000000000000006000006000000006001
1111100000000000060000000006000070000006000000000600000000060001
1111100000000060000000000000000000000000000000000000000000000001
1111100000000000000000600000000000006000000006000000000000060001
1111160000600000060000000000000006000000000000000000600000000601
1111166000000222227000060000000000000000000660000600000007000001
1111199900002222222000000000000600006000000000000000600000000001
1111199990002228222000006000000000000006000000000600000000000001
1111199000002222222000000000006000000000000000060000006000000001
1111199900000222226000000000600000000060000000660000006600000001
1111160000600000000000000000006000000000000000000600000060000001
1111160000000006000000000000000000000000000600000000000000000001
1111100000000000000006000060000000060000000000000000000006000001
1111100600000000600000000000000000000060000000006000000000000001
1111100000000000000000000000600000600000060000000000000666000061
1111160000000600000000000000000060000000000000000000000060000661
1111100060000000000000000006000000006000000000600000006000000001
1111100060000000006000000000060000000060000000006000000006000001
1111100000000000600000000000000000060000000099999600000000000001
1111160000000000000000000006000000000000999999999900000000000061
1111100000000000000006000000006000000009999999999900600006000001
1111100062220000006000000000006600000009999999999000000000006001
1111100000220006000000000006000000600060999999900000000060000001
1111160000000000000007600000000000000000000000999000000060000061
1111100006000000600000000000060000000000000000000000000000600001
1111160000000060000000000000000060000006000000000000600000000001
1111166006000060060000006000000000000000000000006000000000006001
1111166666600000000000000000000000000000060000000000000000000001
1111166660000000600000000000007222222270000000000060000600000601
1111166000000000000006600002222222222000000006000000000000000001
1111100000699999900000000000022222220000000000999999999000000061
1111100999999000999999000000000000600000000099999960009999990001
1111199960000000006099999000000000000009999990000000000000099991
1111100000000000000000999999000099999999990000000000000006000001
1111100000000000000000000999999990000060000000000006000000000001
1111100000000000000700070000000000000000000000000000000000000001
1111100000000000000000020000000000000000000000000000000000000001
1111100000000000000060000000000000000000000000000000000000000001
1111100000600000000702070000000000000000000000600000000000000001
1111100000000000000000000000000000000000000000222000000000000001
1111100000000000000000220000000000000000000002222220000000000001
1111100000000000600700070000000000060000000000022220000000000001
1111100000000000006000200000000000000000000000000000000000070061
1111133333333333333344433333333300000000000000000000000000000001
1111103444444300000344430000000300000000000000000000000000000001
1111103444444300000344430000000333333333333333333333333324433331
1111103444444333333344433333330000003444444444444444444344430001
1111103444444444444444443444430000003444444444444444444344430601
1111103444444444444444443444430033333333334443333344444344433331
1111103444444444444444443444430034445444434443000344444344444431
1111103333333344433344433444430034444444434443000333443344444431
1111100000003999999944444444430034444444434443000344444444444431
1111100000003309999944444444433334444444444443000344444444444431
1111100000003333333333444444444444443334444443000344444444444431
1111100000000000000003333344444444999999999999000344444444444431
1111100000000000000000000000333399999999999999999333333333333331
1111111111111111111111111111111111111111111111111111111111111111