11111111111111111111111111111111
11111111111111111111111111111111
11111111111111111111111111111111
11111111111111111111111111111111
11111997222222999999222279922111
11111999999999940699999999999991
11111999000699943699948999799911
11111999422999922299946999999111
11111999499999999999946999999911
11111962299979999999994000399941
11111799999999999999902222369941
11111999799999946999469999369941
11111999999999946999469999369941
11111990099469946606999999999941
11111992299469943699900079999941
11111999999999922299922299469941
11111990099999999999999999469941
11111992299900000000999999469941
11111999999922222222999999469941
11111999900999999999999999999941
11111699922999999930000006999991
11111699997994699932222226999641
11111699999994699930000006999641
11111299999999999933333336999641
11111930000099999999999226999641
11111332222299999900999999999991
11111340399999999946990099999991
11111345699900099946992299000941
11111322299922299946999999222941
11111999999999999922999999999991
11111000000000000000000000000001
11111111111111111111111111111111