11111111111111111111111111111111
11111111111111111111111111111111
11111111111111111111111111111111
11111111111111111111111111111111
11111222223444439999994449911111
11111222222444433349994999333331
11111222223444434444399999344431
11111222223343334444344954444431
11111776722222233433344444444431
11111666667762222222223333343331
11111776666667767222222222343221
11111222222266666766772222222221
11111330322222226666677677276661
11111300322222222222666666266661
11111300333303333332222277276761
11111303300000300033333322222221
11111300006700000034444332222211
11111300307600330030000422222211
11111300300333300030000322223221
11111300333311300000000333223321
11111300384311300030000300000321
11111300344311300033333300000331
11111300000033330330000000000231
11111300000000000000000000003331
11111300000000333000000000000001
11111333330033313000667767760001
11111000000000313000667766760001
11111000000000313000762222670001
11111900000000333000672222760001
11111990000000000000762222760001
11111999000000000000672222670001
11111111111111111111111111111111