1111111111111111111111111111111111111111111111111111111111111111
1111111111111111111111111111111111111111111111111111111111111111
1111111111111111111111111111111111111111111111111111111111111111
1111111111111111111111111111111111111111111111111111111111111111
1111140000005566755577755995566666000000020000000004000055667791
1111100200000006655577955775500000000004000240002000000006579991
1111100004000000200055660000020000077500000000000400000400555671
1111170000006000000000000000000006565700000002000000000000000561
1111165000000000033300000040000002066950000500000005000020000001
1111176565000000000300000002000000000004000000000005600002000001
1111100005650000000300000000000004000000000020000040000000040061
1111167000000005569976597765900000556670000557766900020000002651
1111100000000066799596759660000000066759000065750020000006040051
1111100005020005566575995565003333333000004000000000400000000001
1111100000000006655779966550003000000200500005575000000000200001
1111100600000000576599779650003000003000000066797796500000000051
1111150000004000057600657655003000003000000407799797665000070201
1111160000000000659000655796503330333000020066997756770000066001
1111165000200006657005560000020000020000000676670007796500005021
1111177600040000006555675500000000000004000000000000670000000001
1111199700000025000000005579600000200000000400000200000000004001
1111197650000000004000000669000000000000065000000400000000033331
1111167565500000000000005567556969550000000000500000020000000001
1111156760000400000000066559797555667700000000000765000040005021
1111176500000000656779000999776655659960000500200067000000000001
1111167500050020076077600000055660000000040006000059600000500001
1111196000000000556977650000000556000020000000020000000000560001
1111175000004000677795697600000000200000000004000000400000000051
1111150000000000056779677500000004000565666670020000000006000051
1111100000000000077799976650000500000055665666000400360020000061
1111100333330000005569700665000000000066556660000050000000000051
1111100300030000006679960565000000002000665560000000000700400561
1111100000000006677699765670000000000040667660000500000000004051
1111100300030005657797967797600030050000556660000000600030005001
1111100333330000565777979776600030000000020000007000000600700001
1111100200000000677667677667600033000000000000300005000000000001
1111100056700000066655776650000000000050000000300000007005006201
1111100006500040005566776655000006000200000000000050000020000001
1111100000670000000566766650000000000000004000400000006007050001
1111100040000200000005566760000000000000060000556500000000000001
1111100000000000000000065500000020000000002000665700000060000001
1111100000200000005000000000200000000000000000577500000000000561
1111100000000000000000020000000050040500000006675500000000000001
1111100000000000000000000560000000000000000000000000000000050001
1111100000000556600000005560333333333333000000000000005020000001
1111100000000667565000000000304000000003000000000000600006000001
1111150000005566577600000000300020020003330033333000000400000001
1111166000066667755776600000300000800003040002003077000500000001
1111176000055566777977600000320000200403000000403000000000567001
1111197620005566777997000000300020000000000002003000000000067001
1111179770004556677660000000300000004000200000043000050000056001
1111177976200667755560000000333333333333333203333000000060006001
1111197776000055567665000005000000002003200000003000000000006701
1111199776600006655600000000000006000003000004003000500000040651
1111177665567002000000040500000000040003020000023000004005000061
1111177667656500000000000000200000000003000400003000000000064021
1111199776650000004000500400000020000003333003333002000600556671
1111177996000000033200000000200000500000000002000000500000056791
1111166769660004030000020000500000000040000000004000006040000021
1111177797766000006570000000000000000000005566200000200000005001
1111179779770020066776000004000060000002000657600400000000020001
1111199977997766677665500000020000000000000056566000005040000001
1111199997776655776677550000000000040000000667767760400002004051
1111111111111111111111111111111111111111111111111111111111111111